pj,pg,pe,pp,puntos,gf,ge,dg,Clase,equipo
18,12,8,0,52,21,19,2,4,0
29,28,4,24,20,32,18,14,2,1
27,17,6,8,39,24,12,12,3,2
18,18,0,18,0,39,8,31,1,3
18,6,0,1,15,43,8,35,2,4
28,1,1,0,5,39,18,21,1,5
21,18,18,0,90,36,36,0,5,6
22,0,0,0,0,43,4,39,1,7
15,7,5,0,31,41,23,18,3,8
30,13,3,10,15,53,28,25,2,9
29,17,8,9,40,48,14,34,3,10
18,16,5,9,31,48,8,40,3,11
18,7,6,1,30,40,21,19,3,12
24,23,12,9,66,49,43,6,5,13
26,0,0,0,0,43,41,2,1,14
25,20,9,11,45,25,16,9,4,15
28,18,2,14,16,49,9,40,2,16
21,21,14,7,70,40,31,9,5,17
29,2,2,0,10,37,24,13,1,18
26,14,10,0,62,50,15,35,5,19
22,20,1,6,44,47,35,12,4,20
28,10,7,3,35,31,7,24,3,21
25,19,14,2,79,59,40,19,5,22
19,17,15,2,75,32,21,11,5,23
17,17,0,11,18,25,7,18,2,24
24,7,4,3,20,56,49,7,2,25
23,10,2,4,22,26,11,15,2,26
18,18,6,12,30,21,19,2,3,27
18,1,0,0,3,53,36,17,1,28
24,24,11,12,58,31,11,20,4,29
25,7,4,3,20,47,27,20,2,30
26,21,21,0,105,50,17,33,5,31
29,23,10,2,83,50,46,4,5,32
26,8,0,2,18,24,8,16,2,33
21,4,4,0,20,20,15,5,2,34
21,8,0,3,15,29,18,11,2,35
21,7,1,3,14,38,36,2,2,36
24,13,0,6,21,22,11,11,2,37
30,29,9,20,45,46,27,19,4,38
23,19,16,3,80,33,30,3,5,39
22,7,1,1,20,49,8,41,2,40
16,14,3,4,36,60,44,16,3,41
18,11,11,0,55,23,1,22,4,42
24,12,4,8,20,46,18,28,2,43
20,20,6,1,69,51,36,15,5,44
23,7,1,1,20,49,1,48,2,45
27,1,1,0,5,25,25,0,1,46
26,19,11,8,55,46,44,2,4,47
17,14,11,3,55,34,24,10,4,48
26,26,9,17,45,25,21,4,4,49
30,27,20,2,115,54,34,20,5,50
27,27,4,20,29,25,25,0,3,51
19,6,0,2,12,50,5,45,2,52
21,2,2,0,10,22,21,1,1,53
21,2,2,0,10,42,27,15,1,54
30,2,0,0,6,49,39,10,1,55
23,8,6,2,30,43,27,16,3,56
25,19,2,12,25,50,50,0,2,57
30,27,19,8,95,43,29,14,5,58
21,19,1,8,35,27,23,4,3,59
26,18,1,17,5,43,13,30,1,60
30,15,1,12,11,27,20,7,2,61
21,7,4,0,29,28,13,15,3,62
28,9,7,1,38,37,16,21,3,63
16,1,1,0,5,50,41,9,1,64
23,16,5,7,37,59,30,29,3,65
18,16,2,1,49,24,16,8,4,66
23,21,14,7,70,45,40,5,5,67
22,13,6,7,30,27,13,14,3,68
17,1,1,0,5,26,20,6,1,69
25,4,2,2,10,53,37,16,1,70
19,15,4,8,29,44,16,28,3,71
23,22,6,8,54,27,23,4,4,72
24,9,8,1,40,39,11,28,3,73
18,9,6,1,36,50,12,38,3,74
29,13,6,7,30,56,23,33,3,75
27,0,0,0,0,29,8,21,1,76
23,19,4,7,44,30,18,12,4,77
29,19,13,5,68,23,19,4,5,78
15,1,1,0,5,56,22,34,1,79
25,15,4,7,32,55,51,4,3,80
25,3,3,0,15,21,18,3,2,81
21,17,12,5,60,25,7,18,5,82
30,24,24,0,120,38,2,36,5,83
16,5,3,1,18,48,31,17,2,84
27,18,11,7,55,22,1,21,4,85
21,1,0,1,0,33,31,2,1,86
29,10,7,0,44,32,2,30,4,87
18,8,0,1,21,43,35,8,2,88
17,1,0,0,3,35,9,26,1,89
23,21,6,15,30,34,28,6,3,90
25,25,9,12,57,37,28,9,4,91
15,10,10,0,50,59,15,44,4,92
15,15,10,5,50,47,2,45,4,93
20,9,3,6,15,60,21,39,2,94
18,12,1,1,35,56,54,2,3,95
25,7,6,1,30,22,3,19,3,96
30,18,13,5,65,50,8,42,5,97
25,12,6,3,39,60,14,46,3,98
30,0,0,0,0,33,6,27,1,99
29,20,6,12,36,25,4,21,3,100
22,12,6,4,36,35,10,25,3,101
29,12,11,1,55,25,13,12,4,102
15,0,0,0,0,40,21,19,1,103
23,9,6,3,30,57,57,0,3,104
19,0,0,0,0,33,33,0,1,105
15,5,0,2,9,52,11,41,1,106
27,19,14,4,73,23,14,9,5,107
25,19,2,9,34,50,6,44,3,108
19,13,12,1,60,38,4,34,5,109
22,11,2,5,22,43,36,7,2,110
23,21,15,6,75,25,21,4,5,111
30,19,1,12,23,29,9,20,2,112
24,21,5,9,46,45,30,15,4,113
25,11,1,2,29,51,8,43,3,114
17,14,4,3,41,59,42,17,4,115
28,15,5,5,40,53,14,39,3,116
29,21,10,6,65,52,26,26,5,117
19,13,11,2,55,60,1,59,4,118
30,20,4,1,65,48,11,37,5,119
15,13,3,1,42,35,25,10,4,120
29,9,9,0,45,42,19,23,4,121
17,15,10,5,50,46,33,13,4,122
18,0,0,0,0,53,11,42,1,123
27,10,3,1,33,39,26,13,3,124
29,4,0,1,9,51,42,9,1,125
25,25,12,13,60,56,34,22,5,126
21,4,1,1,11,51,21,30,2,127
17,16,6,10,30,39,2,37,3,128
26,5,0,4,3,42,32,10,1,129
28,20,19,1,95,47,29,18,5,130
23,1,0,1,0,41,38,3,1,131
23,20,17,3,85,36,32,4,5,132
22,22,21,1,105,31,20,11,5,133
15,12,8,4,40,35,28,7,3,134
17,13,0,7,18,40,32,8,2,135
27,25,6,19,30,41,35,6,3,136
24,15,13,2,65,33,18,15,5,137
16,14,10,0,62,23,5,18,5,138
23,19,6,8,45,43,22,21,4,139
21,13,12,1,60,58,31,27,5,140
22,21,0,12,27,56,39,17,3,141
28,7,3,4,15,47,44,3,2,142
29,19,19,0,95,45,20,25,5,143
20,3,1,1,8,51,49,2,1,144
29,23,15,8,75,52,31,21,5,145
15,9,6,3,30,27,14,13,3,146
24,22,10,5,71,48,31,17,5,147
28,9,9,0,45,31,9,22,4,148
21,12,10,2,50,35,9,26,4,149
23,23,22,1,110,42,29,13,5,150
23,13,1,0,41,50,13,37,4,151
22,16,6,2,54,40,12,28,4,152
17,11,0,7,12,40,5,35,2,153
22,20,19,1,95,24,8,16,5,154
28,14,4,7,29,53,24,29,3,155
20,4,1,0,14,25,12,13,2,156
27,2,0,2,0,52,37,15,1,157
23,10,1,9,5,56,33,23,1,158
23,2,2,0,10,55,6,49,1,159
17,16,11,4,58,48,43,5,4,160
20,0,0,0,0,31,21,10,1,161
19,19,3,0,63,43,30,13,5,162
22,21,0,19,6,56,41,15,1,163
16,15,4,8,29,32,3,29,3,164
20,13,10,3,50,41,4,37,4,165
25,16,4,0,56,35,24,11,4,166
16,1,1,0,5,32,1,31,1,167
28,3,1,2,5,44,5,39,1,168
18,10,10,0,50,50,50,0,4,169
30,28,12,16,60,26,1,25,5,170
16,16,15,1,75,40,17,23,5,171
20,5,5,0,25,43,22,21,2,172
22,18,10,8,50,39,33,6,4,173
15,8,0,4,12,57,2,55,2,174
21,9,8,1,40,39,23,16,3,175
23,19,17,2,85,50,16,34,5,176
29,2,0,0,6,56,2,54,1,177
27,4,0,3,3,55,22,33,1,178
19,16,7,8,38,36,19,17,3,179
23,20,2,2,58,37,15,22,4,180
19,12,12,0,60,48,23,25,5,181
19,6,0,5,3,52,4,48,1,182
29,25,8,17,40,44,1,43,3,183
19,15,4,2,47,44,4,40,4,184
20,19,1,1,56,36,1,35,4,185
15,15,3,12,15,35,34,1,2,186
30,25,20,5,100,33,18,15,5,187
27,16,3,6,36,30,13,17,3,188
29,4,2,2,10,48,48,0,1,189
17,8,4,0,32,24,13,11,3,190
29,26,20,6,100,52,23,29,5,191
17,16,16,0,80,26,22,4,5,192
16,15,9,6,45,29,20,9,4,193
17,6,1,2,14,44,9,35,2,194
26,2,2,0,10,35,22,13,1,195
22,13,11,0,61,36,25,11,5,196
22,21,18,1,96,46,44,2,5,197
29,19,9,10,45,58,22,36,4,198
24,18,14,4,70,58,12,46,5,199
24,0,0,0,0,54,12,42,1,200
15,15,10,5,50,35,16,19,4,201
27,10,8,2,40,52,40,12,3,202
28,6,5,1,25,53,9,44,2,203
26,22,6,5,63,51,16,35,5,204
24,8,0,0,24,27,5,22,2,205
15,4,2,0,16,23,3,20,2,206
26,2,2,0,10,20,8,12,1,207
26,16,15,1,75,46,13,33,5,208
18,4,1,3,5,33,10,23,1,209
17,0,0,0,0,54,40,14,1,210
30,23,8,15,40,34,24,10,3,211
17,11,10,1,50,28,26,2,4,212
19,5,4,1,20,47,5,42,2,213
16,4,0,3,3,56,25,31,1,214
18,17,2,3,46,56,13,43,4,215
21,4,4,0,20,31,30,1,2,216
21,8,3,5,15,25,12,13,2,217
23,18,12,6,60,55,32,23,5,218
20,10,4,5,23,39,4,35,2,219
26,15,11,0,67,44,10,34,5,220
16,1,1,0,5,55,44,11,1,221
27,7,1,4,11,52,7,45,2,222
16,2,0,2,0,22,12,10,1,223
20,0,0,0,0,53,50,3,1,224
27,4,0,2,6,55,38,17,1,225
18,17,14,3,70,29,9,20,5,226
30,27,12,12,69,52,5,47,5,227
25,22,19,3,95,56,17,39,5,228
29,10,3,4,24,57,27,30,2,229
18,7,7,0,35,38,18,20,3,230
29,19,10,6,59,25,3,22,4,231
17,5,2,0,19,45,36,9,2,232
20,11,2,2,31,37,5,32,3,233
21,9,6,3,30,25,7,18,3,234
24,4,3,0,18,51,29,22,2,235
17,6,6,0,30,47,23,24,3,236
19,11,4,2,35,55,17,38,3,237
25,7,7,0,35,54,44,10,3,238
20,9,6,3,30,23,2,21,3,239
27,24,14,10,70,35,14,21,5,240
20,13,1,4,29,34,24,10,3,241
17,1,0,0,3,60,23,37,1,242
23,10,0,6,12,31,16,15,2,243
17,2,0,0,6,36,18,18,1,244
28,20,1,18,8,25,12,13,1,245
18,7,0,5,6,59,16,43,1,246
29,25,4,16,35,57,33,24,3,247
20,14,11,3,55,47,47,0,4,248
24,12,7,5,35,33,17,16,3,249
26,15,4,4,41,33,27,6,4,250
27,7,7,0,35,59,11,48,3,251
25,0,0,0,0,59,24,35,1,252
23,6,3,3,15,48,44,4,2,253
28,14,11,1,61,43,12,31,5,254
19,18,0,8,30,50,20,30,3,255
30,28,11,17,55,20,10,10,4,256
22,21,3,13,30,28,13,15,3,257
27,2,0,1,3,54,33,21,1,258
17,9,1,8,5,28,18,10,1,259
28,19,17,2,85,32,1,31,5,260
25,25,9,3,84,46,35,11,5,261
25,8,3,3,21,34,32,2,2,262
15,10,3,7,15,44,12,32,2,263
21,5,1,0,17,58,22,36,2,264
21,11,1,8,11,33,28,5,2,265
29,19,3,3,54,34,6,28,4,266
24,10,6,4,30,49,32,17,3,267
15,11,8,0,49,56,53,3,4,268
15,12,2,8,16,28,13,15,2,269
17,17,15,2,75,28,12,16,5,270
29,0,0,0,0,25,9,16,1,271
30,15,0,8,21,47,14,33,2,272
25,0,0,0,0,27,7,20,1,273
23,21,7,14,35,28,25,3,3,274
20,13,6,7,30,44,43,1,3,275
27,16,2,7,31,36,16,20,3,276
27,24,13,11,65,47,16,31,5,277
15,14,11,3,55,36,34,2,4,278
28,28,27,1,135,30,8,22,5,279
26,19,17,2,85,26,19,7,5,280
19,13,10,3,50,42,10,32,4,281
25,8,8,0,40,45,33,12,3,282
16,3,2,1,10,57,14,43,1,283
17,0,0,0,0,45,45,0,1,284
22,1,0,0,3,42,42,0,1,285
28,21,10,11,50,26,12,14,4,286
24,1,1,0,5,49,11,38,1,287
18,7,6,1,30,31,26,5,3,288
23,17,5,6,43,53,13,40,4,289
18,12,8,3,43,55,53,2,4,290
17,1,0,0,3,36,32,4,1,291
22,9,9,0,45,39,10,29,4,292
19,7,5,0,31,60,14,46,3,293
16,15,8,6,43,35,16,19,4,294
29,19,7,6,53,44,10,34,4,295
16,14,12,2,60,38,24,14,5,296
21,12,12,0,60,31,25,6,5,297
27,12,5,7,25,36,4,32,2,298
18,11,4,1,38,57,24,33,3,299
22,1,1,0,5,51,5,46,1,300
29,6,1,0,20,43,27,16,2,301
15,11,10,1,50,23,2,21,4,302
26,12,1,5,23,45,17,28,2,303
30,14,4,10,20,59,1,58,2,304
16,5,3,1,18,26,3,23,2,305
28,27,18,1,114,39,18,21,5,306
26,3,2,0,13,54,7,47,2,307
30,6,2,4,10,47,27,20,1,308
26,2,1,1,5,39,15,24,1,309
28,18,0,3,45,23,6,17,4,310
27,19,0,8,33,43,22,21,3,311
19,12,4,0,44,37,26,11,4,312
29,10,0,5,15,22,12,10,2,313
25,23,17,6,85,34,12,22,5,314
16,4,1,2,8,44,26,18,1,315
28,4,4,0,20,25,21,4,2,316
27,27,15,11,78,31,7,24,5,317
22,10,2,1,31,54,13,41,3,318
24,6,5,1,25,58,19,39,2,319
15,2,2,0,10,20,1,19,1,320
19,12,7,0,50,33,14,19,4,321
27,27,21,6,105,26,8,18,5,322
24,4,4,0,20,32,20,12,2,323
23,23,13,7,74,30,12,18,5,324
16,8,2,6,10,34,1,33,1,325
24,15,15,0,75,47,9,38,5,326
20,7,0,7,0,54,3,51,1,327
24,24,4,20,20,32,27,5,2,328
25,20,10,0,80,33,4,29,5,329
27,7,1,2,17,47,36,11,2,330
29,6,2,4,10,42,35,7,1,331
22,7,2,5,10,23,10,13,1,332
21,0,0,0,0,45,8,37,1,333
24,21,3,6,51,22,13,9,4,334
17,16,8,4,52,49,12,37,4,335
30,23,5,12,43,43,32,11,4,336
18,3,2,1,10,52,9,43,1,337
24,6,6,0,30,41,4,37,3,338
17,3,1,2,5,26,3,23,1,339
27,25,21,4,105,53,11,42,5,340
17,14,4,0,50,50,35,15,4,341
30,12,11,1,55,21,5,16,4,342
17,16,14,2,70,27,11,16,5,343
16,2,2,0,10,60,21,39,1,344
26,2,1,0,8,58,12,46,1,345
17,8,3,1,27,27,7,20,3,346
28,7,1,4,11,53,44,9,2,347
23,12,0,4,24,54,52,2,2,348
17,10,0,5,15,29,29,0,2,349
20,4,3,1,15,32,3,29,2,350
20,0,0,0,0,45,43,2,1,351
25,1,1,0,5,57,25,32,1,352
22,10,1,2,26,40,29,11,3,353
30,11,7,4,35,25,19,6,3,354
26,16,13,3,65,42,41,1,5,355
27,8,1,4,14,31,8,23,2,356
15,5,4,1,20,51,23,28,2,357
28,10,1,0,32,52,36,16,3,358
17,17,1,9,26,24,3,21,3,359
23,18,9,9,45,27,13,14,4,360
29,7,2,5,10,26,7,19,1,361
22,18,17,1,85,54,52,2,5,362
23,20,19,1,95,38,5,33,5,363
19,17,17,0,85,55,41,14,5,364
23,15,4,11,20,59,56,3,2,365
23,8,3,4,18,49,8,41,2,366
24,3,2,1,10,30,11,19,1,367
26,12,5,7,25,20,5,15,2,368
27,4,4,0,20,59,52,7,2,369
25,21,21,0,105,43,2,41,5,370
19,8,3,3,21,25,5,20,2,371
25,22,17,2,94,49,29,20,5,372
22,10,0,6,12,53,51,2,2,373
26,15,2,4,37,54,29,25,3,374
15,13,9,4,45,42,10,32,4,375
27,0,0,0,0,33,20,13,1,376
28,16,4,2,50,28,21,7,4,377
26,6,4,2,20,20,16,4,2,378
30,20,19,1,95,33,28,5,5,379
17,16,11,2,64,26,26,0,5,380
22,8,6,1,33,39,30,9,3,381
20,4,1,1,11,40,25,15,2,382
21,12,11,1,55,49,20,29,4,383
22,7,5,2,25,53,23,30,2,384
22,20,16,4,80,39,21,18,5,385
24,2,0,2,0,54,18,36,1,386
23,14,4,2,44,32,9,23,4,387
20,5,3,2,15,34,32,2,2,388
20,15,8,2,55,27,14,13,4,389
16,15,7,8,35,54,32,22,3,390
20,11,8,0,49,33,25,8,4,391
25,15,2,3,40,43,42,1,3,392
15,0,0,0,0,24,3,21,1,393
25,10,7,3,35,29,29,0,3,394
19,5,5,0,25,20,1,19,2,395
20,12,11,1,55,31,18,13,4,396
23,4,0,3,3,31,15,16,1,397
20,4,0,4,0,59,48,11,1,398
23,17,5,0,61,32,20,12,5,399
19,13,6,7,30,32,12,20,3,400
16,10,5,1,37,20,12,8,3,401
22,19,17,2,85,32,10,22,5,402
24,19,15,4,75,45,6,39,5,403
25,1,0,0,3,26,15,11,1,404
22,22,18,4,90,41,19,22,5,405
21,12,4,1,41,31,10,21,4,406
21,21,4,17,20,43,3,40,2,407
27,20,14,6,70,40,29,11,5,408
17,12,6,4,36,56,3,53,3,409
27,12,10,2,50,29,25,4,4,410
21,21,11,1,82,34,1,33,5,411
21,5,4,1,20,20,13,7,2,412
27,10,8,2,40,50,20,30,3,413
21,6,2,4,10,30,10,20,1,414
21,8,4,0,32,39,29,10,3,415
19,9,8,1,40,34,13,21,3,416
22,8,1,1,23,30,25,5,2,417
22,21,20,1,100,42,33,9,5,418
15,13,9,4,45,40,21,19,4,419
25,5,5,0,25,60,26,34,2,420
20,14,9,5,45,57,14,43,4,421
27,4,0,3,3,26,7,19,1,422
27,25,4,6,65,54,39,15,5,423
28,18,5,1,61,34,30,4,5,424
15,11,10,1,50,29,9,20,4,425
22,18,15,3,75,26,23,3,5,426
22,20,1,19,5,30,20,10,1,427
17,12,11,1,55,52,24,28,4,428
28,27,20,1,118,52,14,38,5,429
28,0,0,0,0,50,42,8,1,430
15,9,6,1,36,44,30,14,3,431
18,12,8,3,43,50,4,46,4,432
17,15,2,5,34,25,24,1,3,433
28,17,8,2,61,52,19,33,5,434
24,17,3,14,15,26,22,4,2,435
18,18,6,1,63,36,17,19,5,436
21,20,9,11,45,60,54,6,4,437
28,6,3,0,24,49,40,9,2,438
19,18,12,2,72,37,4,33,5,439
15,7,1,2,17,27,15,12,2,440
18,5,3,2,15,27,1,26,2,441
27,24,2,16,28,41,36,5,3,442
21,5,1,1,14,35,35,0,2,443
24,19,12,7,60,33,22,11,5,444
23,15,10,5,50,37,12,25,4,445
19,6,6,0,30,43,34,9,3,446
17,14,10,0,62,22,21,1,5,447
20,11,4,4,29,29,20,9,3,448
18,18,0,5,39,35,28,7,3,449
18,9,9,0,45,37,13,24,4,450
28,7,5,0,31,21,6,15,3,451
22,10,8,2,40,30,11,19,3,452
27,27,1,20,23,51,27,24,2,453
29,5,1,0,17,50,9,41,2,454
21,17,8,9,40,21,5,16,3,455
29,7,7,0,35,29,24,5,3,456
22,22,1,13,29,20,18,2,3,457
25,18,13,5,65,49,48,1,5,458
24,22,10,8,62,45,15,30,5,459
19,13,2,9,16,24,11,13,2,460
23,11,9,2,45,54,34,20,4,461
19,13,11,2,55,60,48,12,4,462
19,14,0,14,0,20,11,9,1,463
28,3,3,0,15,25,25,0,2,464
29,29,27,2,135,25,19,6,5,465
19,7,5,1,28,22,16,6,3,466
28,24,23,1,115,37,22,15,5,467
28,5,1,4,5,28,17,11,1,468
25,14,13,0,68,20,16,4,5,469
15,4,0,1,9,52,37,15,1,470
22,11,9,2,45,27,8,19,4,471
28,20,10,10,50,58,40,18,4,472
21,20,18,2,90,25,12,13,5,473
19,18,7,9,41,31,9,22,4,474
26,18,7,11,35,38,35,3,3,475
20,17,6,11,30,56,53,3,3,476
15,7,2,5,10,54,53,1,1,477
17,2,0,2,0,29,6,23,1,478
22,12,3,6,24,46,28,18,2,479
26,3,2,1,10,28,27,1,1,480
17,10,2,3,25,42,16,26,2,481
22,11,9,2,45,51,36,15,4,482
22,9,1,8,5,41,9,32,1,483
27,10,1,8,8,22,11,11,1,484
20,8,8,0,40,34,8,26,3,485
24,1,0,0,3,57,29,28,1,486
16,16,6,10,30,39,29,10,3,487
16,7,4,3,20,50,24,26,2,488
15,8,3,2,24,35,23,12,2,489
28,3,3,0,15,49,28,21,2,490
15,3,1,0,11,44,8,36,2,491
30,3,1,2,5,36,3,33,1,492
29,16,2,10,22,31,14,17,2,493
21,20,18,2,90,39,19,20,5,494
23,6,0,0,18,38,13,25,2,495
23,21,20,1,100,57,7,50,5,496
28,11,7,4,35,55,53,2,3,497
15,15,12,3,60,27,14,13,5,498
24,8,8,0,40,26,12,14,3,499
25,10,8,2,40,25,4,21,3,500
16,2,2,0,10,20,16,4,1,501
16,14,6,4,42,29,13,16,4,502
22,1,0,1,0,24,11,13,1,503
23,4,0,0,12,23,13,10,2,504
23,22,20,2,100,32,29,3,5,505
28,8,4,4,20,43,14,29,2,506
15,7,5,2,25,39,31,8,2,507
26,2,2,0,10,55,45,10,1,508
29,9,6,3,30,22,20,2,3,509
25,0,0,0,0,21,19,2,1,510
21,12,5,7,25,28,6,22,2,511
17,2,0,0,6,50,37,13,1,512
28,28,11,12,70,39,26,13,5,513
17,7,6,1,30,22,14,8,3,514
25,8,8,0,40,40,40,0,3,515
24,23,2,21,10,47,22,25,1,516
19,1,0,1,0,60,21,39,1,517
26,17,10,7,50,34,12,22,4,518
30,19,14,5,70,37,23,14,5,519
24,1,0,0,3,50,36,14,1,520
27,21,15,6,75,44,21,23,5,521
29,12,1,6,20,33,32,1,2,522
28,28,5,23,25,27,22,5,2,523
26,16,14,2,70,34,12,22,5,524
23,2,2,0,10,45,14,31,1,525
29,12,11,1,55,49,19,30,4,526
18,11,10,0,53,27,20,7,4,527
27,20,20,0,100,35,15,20,5,528
27,19,13,6,65,31,29,2,5,529
17,5,5,0,25,54,19,35,2,530
23,23,14,6,79,21,11,10,5,531
20,19,18,1,90,60,14,46,5,532
15,6,5,1,25,44,4,40,2,533
20,19,0,12,21,24,16,8,2,534
20,14,14,0,70,33,2,31,5,535
24,17,6,4,51,21,6,15,4,536
19,10,9,1,45,40,19,21,4,537
24,19,5,4,55,58,40,18,4,538
27,23,7,12,47,52,10,42,4,539
23,21,7,9,50,21,4,17,4,540
26,16,10,6,50,20,15,5,4,541
19,13,8,4,43,50,44,6,4,542
27,5,2,3,10,31,30,1,1,543
21,16,0,0,48,50,38,12,4,544
28,5,4,1,20,31,16,15,2,545
22,4,3,1,15,58,56,2,2,546
20,3,0,2,3,50,15,35,1,547
27,19,3,15,18,37,34,3,2,548
27,26,16,1,107,60,49,11,5,549
18,17,8,9,40,40,28,12,3,550
29,23,16,7,80,29,22,7,5,551
20,19,16,2,83,51,34,17,5,552
24,2,1,0,8,29,23,6,1,553
23,15,1,14,5,60,22,38,1,554
24,1,0,1,0,37,10,27,1,555
27,3,1,0,11,47,22,25,2,556
21,8,6,2,30,51,28,23,3,557
25,4,1,2,8,33,30,3,1,558
28,6,1,0,20,28,13,15,2,559
22,11,8,0,49,48,39,9,4,560
23,14,3,11,15,28,9,19,2,561
28,2,0,2,0,43,29,14,1,562
30,7,1,6,5,20,13,7,1,563
29,11,10,0,53,54,43,11,4,564
18,18,3,15,15,57,11,46,2,565
30,0,0,0,0,47,12,35,1,566
24,22,10,2,80,20,18,2,5,567
28,14,9,2,54,38,9,29,4,568
25,7,0,3,12,34,26,8,2,569
20,11,7,3,38,22,10,12,3,570
16,5,3,2,15,42,29,13,2,571
27,22,10,12,50,21,5,16,4,572
24,17,12,5,60,22,12,10,5,573
18,13,12,1,60,29,16,13,5,574
29,5,3,2,15,46,40,6,2,575
26,11,1,0,35,28,5,23,3,576
24,22,19,3,95,39,38,1,5,577
30,18,1,9,29,59,25,34,3,578
17,9,7,2,35,30,29,1,3,579
27,1,0,1,0,37,19,18,1,580
26,15,15,0,75,27,24,3,5,581
30,15,1,10,17,23,8,15,2,582
18,1,0,1,0,42,38,4,1,583
27,27,10,17,50,25,17,8,4,584
20,18,5,12,28,50,23,27,3,585
30,24,12,6,78,39,20,19,5,586
23,9,3,4,21,52,25,27,2,587
27,7,5,2,25,25,12,13,2,588
17,0,0,0,0,45,18,27,1,589
29,25,16,9,80,60,30,30,5,590
16,4,4,0,20,38,11,27,2,591
29,13,9,3,48,26,24,2,4,592
27,6,2,3,13,37,25,12,2,593
21,9,5,4,25,53,29,24,2,594
26,2,1,0,8,20,17,3,1,595
15,8,1,3,17,39,24,15,2,596
20,17,11,4,61,38,34,4,5,597
27,16,11,2,64,45,39,6,5,598
29,1,1,0,5,42,25,17,1,599
29,26,26,0,130,33,9,24,5,600
29,6,5,1,25,48,28,20,2,601
25,1,1,0,5,41,14,27,1,602
18,16,11,5,55,36,20,16,4,603
28,16,4,0,56,52,8,44,4,604
29,6,0,0,18,45,21,24,2,605
17,12,2,9,13,47,13,34,2,606
25,15,3,12,15,30,2,28,2,607
20,19,5,12,31,50,42,8,3,608
23,3,2,0,13,39,24,15,2,609
23,0,0,0,0,34,17,17,1,610
28,5,5,0,25,37,32,5,2,611
15,2,0,1,3,32,6,26,1,612
28,23,6,3,72,25,10,15,5,613
20,11,10,1,50,27,22,5,4,614
16,15,1,6,29,25,20,5,3,615
20,9,2,7,10,42,16,26,1,616
29,1,0,0,3,32,13,19,1,617
22,2,2,0,10,58,16,42,1,618
25,3,0,3,0,27,7,20,1,619
29,17,3,12,21,46,45,1,2,620
19,3,0,2,3,32,29,3,1,621
28,12,3,8,18,33,33,0,2,622
25,5,1,3,8,44,15,29,1,623
19,1,0,1,0,37,33,4,1,624
25,22,8,14,40,21,17,4,3,625
29,9,3,6,15,44,38,6,2,626
22,19,13,6,65,45,11,34,5,627
21,15,11,3,58,44,36,8,4,628
20,16,10,6,50,52,32,20,4,629
15,5,4,1,20,20,14,6,2,630
24,8,4,0,32,41,32,9,3,631
21,20,17,3,85,58,7,51,5,632
21,9,3,6,15,23,15,8,2,633
17,13,8,5,40,53,2,51,3,634
26,14,2,5,31,22,9,13,3,635
24,20,4,5,53,32,9,23,4,636
25,25,4,21,20,60,50,10,2,637
25,6,3,3,15,21,21,0,2,638
30,26,25,1,125,28,24,4,5,639
21,19,12,2,75,55,30,25,5,640
30,20,19,1,95,43,1,42,5,641
19,6,1,2,14,51,14,37,2,642
28,13,5,8,25,35,9,26,2,643
25,15,14,1,70,21,14,7,5,644
20,4,2,0,16,52,25,27,2,645
25,21,2,6,49,46,39,7,4,646
20,15,9,2,57,32,10,22,4,647
19,2,2,0,10,30,30,0,1,648
17,3,2,0,13,23,6,17,2,649
29,24,15,3,93,46,22,24,5,650
28,12,10,2,50,41,37,4,4,651
19,19,12,3,72,32,23,9,5,652
26,21,14,7,70,29,15,14,5,653
27,25,7,15,44,21,12,9,4,654
23,20,10,3,71,33,6,27,5,655
24,0,0,0,0,60,12,48,1,656
18,6,0,3,9,59,24,35,1,657
29,20,10,10,50,34,7,27,4,658
17,3,0,0,9,29,18,11,1,659
15,6,5,1,25,48,46,2,2,660
15,14,14,0,70,54,35,19,5,661
17,17,15,2,75,53,15,38,5,662
28,8,1,5,11,32,10,22,2,663
16,10,5,0,40,34,19,15,3,664
27,15,9,6,45,32,8,24,4,665
23,4,2,2,10,35,28,7,1,666
28,21,19,2,95,51,39,12,5,667
22,20,5,1,67,58,30,28,5,668
30,17,16,1,80,29,29,0,5,669
30,27,15,4,99,30,25,5,5,670
17,17,16,1,80,28,22,6,5,671
30,17,1,7,32,59,26,33,3,672
24,21,6,14,33,54,48,6,3,673
19,5,3,2,15,56,8,48,2,674
24,18,18,0,90,35,11,24,5,675
24,3,2,0,13,55,36,19,2,676
28,14,1,12,8,37,32,5,1,677
28,8,4,3,23,30,27,3,2,678
16,7,5,2,25,49,14,35,2,679
30,12,0,9,9,59,9,50,1,680
28,20,4,3,59,55,8,47,4,681
24,20,18,2,90,23,15,8,5,682
26,22,2,13,31,57,52,5,3,683
20,1,0,1,0,29,24,5,1,684
26,14,1,11,11,34,17,17,2,685
25,14,1,5,29,35,22,13,3,686
28,26,3,10,54,22,8,14,4,687
22,0,0,0,0,21,18,3,1,688
17,6,6,0,30,35,24,11,3,689
16,5,2,3,10,40,11,29,1,690
17,17,1,8,29,58,16,42,3,691
17,15,0,10,15,31,2,29,2,692
23,2,2,0,10,34,19,15,1,693
18,3,0,3,0,39,27,12,1,694
29,9,2,3,22,29,15,14,2,695
19,9,0,2,21,56,28,28,2,696
27,2,2,0,10,39,25,14,1,697
20,6,6,0,30,50,8,42,3,698
27,2,1,0,8,43,28,15,1,699
20,18,16,2,80,41,28,13,5,700
28,24,18,6,90,49,5,44,5,701
20,14,7,7,35,55,31,24,3,702
25,24,11,1,91,33,1,32,5,703
28,3,1,2,5,32,21,11,1,704
18,14,13,1,65,39,2,37,5,705
23,1,0,0,3,28,28,0,1,706
18,3,2,1,10,56,48,8,1,707
27,9,0,0,27,58,26,32,3,708
25,8,8,0,40,32,6,26,3,709
16,8,2,1,25,55,17,38,2,710
20,14,1,4,32,53,51,2,3,711
22,2,1,1,5,28,16,12,1,712
27,6,1,1,17,44,34,10,2,713
28,14,10,4,50,59,30,29,4,714
29,7,5,2,25,42,27,15,2,715
15,15,3,4,39,21,21,0,3,716
16,10,9,1,45,43,7,36,4,717
16,8,7,1,35,23,10,13,3,718
21,17,7,10,35,27,8,19,3,719
19,12,12,0,60,37,36,1,5,720
26,9,3,6,15,30,16,14,2,721
16,15,4,0,53,36,19,17,4,722
29,12,5,7,25,32,17,15,2,723
22,18,5,13,25,37,17,20,2,724
24,18,6,7,45,34,14,20,4,725
25,12,5,7,25,46,22,24,2,726
20,8,8,0,40,35,1,34,3,727
26,9,0,3,18,53,20,33,2,728
26,9,3,1,30,38,11,27,3,729
17,17,16,1,80,27,7,20,5,730
15,2,1,1,5,38,7,31,1,731
21,8,6,2,30,54,49,5,3,732
25,11,5,6,25,34,11,23,2,733
19,13,5,8,25,24,20,4,2,734
27,20,20,0,100,43,1,42,5,735
16,14,2,11,13,48,12,36,2,736
15,0,0,0,0,37,33,4,1,737
18,12,8,4,40,23,22,1,3,738
18,4,2,2,10,33,29,4,1,739
18,2,0,1,3,21,12,9,1,740
26,15,9,6,45,35,18,17,4,741
21,14,12,2,60,41,41,0,5,742
18,17,12,5,60,50,27,23,5,743
25,24,10,14,50,55,7,48,4,744
19,17,10,7,50,39,31,8,4,745
27,21,15,6,75,23,22,1,5,746
29,7,4,1,26,29,18,11,3,747
28,14,13,1,65,53,48,5,5,748
29,8,0,2,18,51,43,8,2,749
17,7,0,6,3,31,1,30,1,750
25,8,6,2,30,55,55,0,3,751
16,8,7,0,38,27,23,4,3,752
29,16,3,13,15,27,27,0,2,753
23,0,0,0,0,37,19,18,1,754
30,19,11,2,73,57,34,23,5,755
26,17,8,9,40,56,8,48,3,756
19,13,8,5,40,44,3,41,3,757
22,19,1,9,32,50,7,43,3,758
29,7,1,2,17,56,3,53,2,759
26,13,1,8,17,28,24,4,2,760
27,27,24,3,120,39,36,3,5,761
26,8,1,7,5,26,17,9,1,762
26,16,4,3,47,42,28,14,4,763
21,0,0,0,0,43,34,9,1,764
30,14,3,8,24,46,11,35,2,765
18,12,9,0,54,59,47,12,4,766
15,1,0,0,3,31,9,22,1,767
17,16,13,3,65,26,26,0,5,768
15,9,3,4,21,56,24,32,2,769
23,4,2,1,13,42,23,19,2,770
17,10,6,3,33,58,48,10,3,771
22,21,18,3,90,49,16,33,5,772
29,17,11,6,55,25,16,9,4,773
25,13,11,2,55,39,23,16,4,774
27,14,9,5,45,26,4,22,4,775
16,10,3,4,24,37,5,32,2,776
15,6,5,1,25,55,42,13,2,777
17,1,1,0,5,31,4,27,1,778
17,7,0,7,0,48,43,5,1,779
26,17,17,0,85,22,5,17,5,780
17,16,1,8,26,47,42,5,3,781
28,22,20,1,103,56,18,38,5,782
20,20,5,10,40,35,35,0,3,783
23,19,3,13,24,28,15,13,2,784
17,7,3,3,18,54,38,16,2,785
28,15,13,2,65,56,19,37,5,786
27,11,4,2,35,33,16,17,3,787
20,13,7,1,50,47,10,37,4,788
23,11,4,7,20,48,4,44,2,789
17,5,4,1,20,49,11,38,2,790
20,20,9,11,45,36,9,27,4,791
28,10,4,0,38,44,39,5,3,792
23,18,12,6,60,54,38,16,5,793
22,11,8,3,40,47,41,6,3,794
25,23,15,8,75,51,34,17,5,795
28,28,22,6,110,33,27,6,5,796
21,7,3,2,21,26,21,5,2,797
24,6,3,3,15,29,15,14,2,798
15,13,7,1,50,54,34,20,4,799
21,21,14,7,70,31,13,18,5,800
27,16,9,6,48,20,4,16,4,801
22,20,6,13,33,41,20,21,3,802
28,26,1,17,29,20,19,1,3,803
20,20,2,12,28,37,22,15,3,804
23,2,0,0,6,38,38,0,1,805
27,10,10,0,50,52,51,1,4,806
27,15,8,7,40,60,15,45,3,807
26,1,0,1,0,35,30,5,1,808
20,19,14,2,79,46,31,15,5,809
18,2,0,0,6,36,16,20,1,810
24,8,4,4,20,31,3,28,2,811
21,11,6,5,30,36,23,13,3,812
24,23,2,4,61,58,39,19,5,813
30,15,11,4,55,29,10,19,4,814
22,4,4,0,20,47,2,45,2,815
16,3,0,2,3,41,38,3,1,816
17,12,12,0,60,27,11,16,5,817
28,7,2,2,19,59,39,20,2,818
29,25,9,16,45,30,5,25,4,819
24,10,6,4,30,50,29,21,3,820
21,18,3,10,30,38,33,5,3,821
24,2,1,1,5,60,14,46,1,822
16,16,16,0,80,56,20,36,5,823
27,3,1,0,11,34,8,26,2,824
27,14,1,13,5,20,17,3,1,825
25,2,2,0,10,30,20,10,1,826
15,8,5,0,34,37,25,12,3,827
27,9,6,1,36,40,24,16,3,828
18,3,2,1,10,37,7,30,1,829
18,11,2,7,16,34,21,13,2,830
28,12,10,1,53,59,9,50,4,831
30,0,0,0,0,21,15,6,1,832
29,13,13,0,65,54,5,49,5,833
29,4,4,0,20,36,30,6,2,834
15,1,1,0,5,37,21,16,1,835
29,19,4,6,47,42,29,13,4,836
28,28,14,2,106,40,36,4,5,837
22,16,9,7,45,32,15,17,4,838
30,4,4,0,20,59,49,10,2,839
22,10,10,0,50,38,32,6,4,840
22,20,1,12,26,31,27,4,3,841
23,21,3,13,30,23,8,15,3,842
15,9,8,1,40,48,24,24,3,843
18,13,8,1,52,39,33,6,4,844
29,2,1,1,5,32,24,8,1,845
28,15,2,4,37,45,31,14,3,846
20,5,2,2,13,21,11,10,2,847
20,5,1,4,5,27,13,14,1,848
21,9,5,1,34,29,7,22,3,849
18,3,0,1,6,21,20,1,1,850
22,4,4,0,20,43,22,21,2,851
20,6,3,3,15,21,6,15,2,852
23,3,2,1,10,55,31,24,1,853
15,3,1,1,8,22,11,11,1,854
28,25,13,12,65,38,28,10,5,855
15,13,0,6,21,42,41,1,2,856
23,11,7,4,35,24,19,5,3,857
26,18,7,11,35,60,22,38,3,858
29,2,2,0,10,37,20,17,1,859
25,2,0,1,3,51,9,42,1,860
30,19,10,9,50,39,21,18,4,861
22,1,1,0,5,50,7,43,1,862
17,4,2,2,10,53,40,13,1,863
25,0,0,0,0,60,18,42,1,864
21,10,6,0,42,52,30,22,4,865
19,19,0,11,24,36,21,15,2,866
29,10,5,3,31,37,5,32,3,867
22,7,7,0,35,31,21,10,3,868
20,8,2,6,10,41,11,30,1,869
25,13,12,1,60,30,10,20,5,870
16,7,2,5,10,41,26,15,1,871
22,22,21,1,105,52,14,38,5,872
22,5,4,1,20,49,39,10,2,873
20,19,1,16,11,42,2,40,2,874
17,9,9,0,45,40,8,32,4,875
30,8,3,0,30,41,6,35,3,876
18,9,9,0,45,26,22,4,4,877
20,14,2,8,22,34,17,17,2,878
25,8,6,2,30,36,15,21,3,879
21,14,8,6,40,43,26,17,3,880
29,19,9,10,45,46,18,28,4,881
22,22,18,4,90,47,13,34,5,882
30,28,16,12,80,31,8,23,5,883
15,6,2,4,10,28,22,6,1,884
28,26,13,0,104,23,23,0,5,885
22,14,3,11,15,21,10,11,2,886
19,0,0,0,0,51,12,39,1,887
18,11,4,4,29,36,12,24,3,888
24,8,0,4,12,48,4,44,2,889
15,8,2,0,28,58,2,56,3,890
25,7,7,0,35,54,9,45,3,891
16,13,11,2,55,35,21,14,4,892
18,13,4,9,20,36,8,28,2,893
24,9,2,6,13,26,16,10,2,894
24,7,4,0,29,35,14,21,3,895
28,1,1,0,5,39,4,35,1,896
16,7,3,0,27,21,17,4,3,897
20,13,3,10,15,43,34,9,2,898
30,21,14,4,79,29,14,15,5,899
15,11,3,1,36,29,21,8,3,900
15,14,1,2,38,31,3,28,3,901
28,10,10,0,50,38,6,32,4,902
25,2,0,1,3,32,3,29,1,903
24,13,12,0,63,35,1,34,5,904
19,3,0,2,3,25,6,19,1,905
24,2,0,1,3,59,21,38,1,906
25,2,0,1,3,32,31,1,1,907
20,12,12,0,60,43,13,30,5,908
21,8,2,2,22,49,49,0,2,909
21,10,3,7,15,25,25,0,2,910
16,8,6,2,30,42,8,34,3,911
27,17,1,4,41,23,14,9,4,912
25,6,6,0,30,40,36,4,3,913
25,25,1,11,44,31,29,2,4,914
29,25,22,3,110,41,31,10,5,915
20,8,6,2,30,26,10,16,3,916
16,15,10,5,50,51,44,7,4,917
30,11,8,3,40,20,15,5,3,918
25,19,7,3,62,38,11,27,5,919
28,8,0,6,6,26,11,15,1,920
21,8,6,2,30,33,13,20,3,921
30,27,5,19,34,23,2,21,3,922
22,11,5,6,25,57,31,26,2,923
15,0,0,0,0,35,19,16,1,924
23,2,1,1,5,46,30,16,1,925
19,17,14,3,70,49,15,34,5,926
18,14,3,8,24,42,34,8,2,927
16,12,4,6,26,39,19,20,3,928
28,0,0,0,0,46,13,33,1,929
16,0,0,0,0,41,30,11,1,930
28,10,7,3,35,50,5,45,3,931
15,9,9,0,45,53,11,42,4,932
30,15,15,0,75,53,40,13,5,933
18,15,13,2,65,39,15,24,5,934
21,11,9,2,45,23,3,20,4,935
16,6,0,0,18,21,10,11,2,936
25,16,15,1,75,60,27,33,5,937
28,6,1,5,5,28,27,1,1,938
21,20,7,12,38,30,10,20,3,939
17,0,0,0,0,26,7,19,1,940
23,9,1,4,17,22,7,15,2,941
28,5,4,1,20,48,15,33,2,942
19,9,1,8,5,33,28,5,1,943
27,27,15,12,75,38,32,6,5,944
22,8,0,4,12,27,5,22,2,945
19,0,0,0,0,25,20,5,1,946
22,18,12,6,60,45,8,37,5,947
20,8,4,4,20,34,18,16,2,948
23,18,10,1,71,39,6,33,5,949
16,2,0,2,0,36,20,16,1,950
22,1,1,0,5,57,57,0,1,951
21,15,3,3,42,36,7,29,4,952
26,14,5,6,34,47,28,19,3,953
16,15,8,7,40,25,11,14,3,954
17,1,0,0,3,21,20,1,1,955
26,24,8,4,76,23,14,9,5,956
24,15,10,5,50,60,37,23,4,957
26,0,0,0,0,46,31,15,1,958
18,17,7,10,35,26,3,23,3,959
28,10,0,8,6,31,24,7,1,960
28,23,12,11,60,29,3,26,5,961
22,4,2,2,10,47,36,11,1,962
23,9,9,0,45,50,37,13,4,963
24,10,5,0,40,56,8,48,3,964
23,13,5,8,25,57,43,14,2,965
15,14,2,4,34,26,11,15,3,966
21,15,7,5,44,36,24,12,4,967
21,15,4,11,20,24,15,9,2,968
26,3,3,0,15,42,24,18,2,969
21,7,7,0,35,53,47,6,3,970
21,19,0,9,30,50,37,13,3,971
25,18,14,4,70,28,16,12,5,972
19,6,0,0,18,22,6,16,2,973
28,1,1,0,5,53,11,42,1,974
19,0,0,0,0,51,18,33,1,975
22,19,2,4,49,27,13,14,4,976
20,13,1,4,29,33,15,18,3,977
20,1,1,0,5,55,8,47,1,978
29,4,0,2,6,28,27,1,1,979
17,12,0,5,21,25,5,20,2,980
26,12,6,1,45,27,21,6,4,981
24,8,1,2,20,30,5,25,2,982
15,2,2,0,10,57,25,32,1,983
24,17,4,6,41,41,26,15,4,984
15,0,0,0,0,51,6,45,1,985
30,16,5,3,49,21,17,4,4,986
23,20,16,4,80,35,30,5,5,987
28,21,7,8,53,27,27,0,4,988
26,1,1,0,5,54,46,8,1,989
20,15,5,9,28,28,3,25,3,990
23,7,5,1,28,23,19,4,3,991
23,13,8,1,52,41,14,27,4,992
22,22,14,7,73,42,8,34,5,993
26,7,6,1,30,30,22,8,3,994
23,7,7,0,35,46,45,1,3,995
19,11,9,2,45,20,3,17,4,996
23,12,2,1,37,50,8,42,3,997
26,9,0,0,27,21,6,15,3,998
18,4,4,0,20,37,30,7,2,999
